1 1 1 1 1 1 1 1 1 1 
1 1 1 1 1 1 1 1 1 1 
1 1 1 1 0 1 0 0 0 1 
1 1 1 1 0 1 0 1 1 1 
1 0 0 0 0 1 0 1 0 0 
1 1 0 1 1 1 0 1 1 1 
1 0 0 1 0 0 0 0 0 1 
1 0 1 1 1 1 1 1 1 1 
0 0 0 0 0 0 0 1 0 0 
1 1 1 1 1 1 1 1 1 1 
33
7 0
6 0
5 0
4 0
3 0
2 0
1 0
1 1
1 2
1 3
1 4
1 5
2 5
3 5
4 5
5 5
5 4
5 3
6 3
7 3
7 4
7 5
7 6
7 7
8 7
9 7
9 6
9 5
9 4
9 3
9 2
9 1
9 0
2.00